NNNNNNNNNNNN
NNSQQQQQQRNN
NNVGGGGGGWNN
NNVGGGGGGWNN
NNVGGGGGGWNN
NNVGGGGGGWNN
NNVGGGGGGWNN
NNVGGGGGGWNN
NNVGGGGGGWNN
NNUZZZZZZTNN
NNNNNNNNNNNN
11,12