TRRRTTRTTTTTTRTRRTTTTTRTTTTTTTTT
TTGGGGGGGGGGGAGGGGTTTTTTGGGGGTTT
TTRGGAGGRRGGGGGGGRRRTGGGTGGGTGTT
TTTGGGGRTRGTGGGRGGGGGGTGGGGGTTRT
TTTGGGGGTGGGGCGGGRGGGGRRGGBGGGTT
TGGGGTTGGAGGGGGGGGGGTGBGGGGGGRTT
TGGGGGGGGGGGTTGGGGGGGGGGGGGRGGGT
TGGGGGGGRGRRGGPGGGGGGGGTGGGGGGGT
TRRGGRGRGGGGGGGGGTTGGGGGGGGGGTTT
TTTTTGGGGGGGGGGGGGTGGGGRGGGGGGRT
TTTTTTTTTRGGRAGGGGRGGGGGGGGRRRGT
TTTGGGGGRGGGGGGGGTTTRRGGGAGRGGGT
TTTGGBGGGGGGGGGGGGGGGGGGGGGGGTTT
TTTTTTTTTTGGGGTTTRRRRRTTTRGGGGGT
TTTTTTTTTTTTTTTTTTTTTTTTTTTTTTTT
15,32