TTTTTTTTTTTTTTTT
TGGGGGBGGGGGGGGT
TGGGRRRRRRRGGGGT
TGGGRAGGGGRGGGGT
TGAGRGRRRGRGGGGT
TGGGRGGCRGRGAGGT
TGBGRRRRRGRGGGGT
TGGGGGGGGGRGGGGT
TGGGGGAGGGRGPGGT
TTTTTTTTTTTTTTTT
10,16