TTTTTTTTTTRRTTTRRRRT
TTRRRRRRTTTTTRTTTTTT
TTAGGGTGGBGGGGGGGGRT
TTTTGGGGGGGGGCGGTRRT
TTRRRGPGRRGGGGGRGGGT
TGGGGGGGGGTGGRGAGGGT
TGGGGBGGGPGGGGRRTGGT
TGGGRGGGGRGGRTTGGGGT
TTTTTGTTTGTTGGGGTGTT
TTTRGGRTTRRRGGGGGRTT
TTTTTTTTTTTTTTTTTTTT
11,20