RRRRRTTRRRRTTRRRRRR
RRRGGPGTGRRRRRRGGBT
TTGGGGRRGGGGGGGTGGR
RRGGRTGRCRRRARGGGGT
TGGTTRGGTTTTTGGGGRR
TBTGGGGGGGGGAGGRRRR
RGGGGRRGGGGRTRRTTRR
TTTTRRRRTTTTTTTRRTT
8,19