TTTTTTTRRTTTRRTTTTT
TTTRRGAGGGGGTTGGGTT
TTRGGGGGGRGGGGGGRTT
TTGGGGRRGGGGGBGRGGT
TGGGGGAGGGPGGGRRGGT
TGBGGRRRTGGCGGGGGGT
TGRGGGTGGGTGGGGRGRT
TTTTGGTGGGGGGGTGGGT
TTTTTTTTTTRTRRGGAGT
TTTTTTTTTTTTTTTTTTT
10,19