GGGGGGGGGGGGGGGGGGGG
GGGGGGGGGGGGGGGGGGGG
GGGGGXZZZZZYGGGGGGGG
GGGGGWNNNNNVGGGGGGGG
GGGGGOQQRNNVGGGGGGGG
GGGGGGGGWNNVGGGGGGGG
GGGGGGGGOQQPGGGGGGGG
GGGGGGGGGGGGGGGGGGGG
GGGGGGGGGGGGGGGGGGGG
GGGGGGGGGGGGGGGGGGGG
GGGGGGGGGGGGGGGGGGGG
11,20