TTTTTTTTTTTT
TTTTTTTTTTTT
TTTCGGGGGTTT
TTTGGGGGGTTT
TTTGGGGAGTTT
TGGGGGGGGGGT
TTGGBGGGGGTT
TTTGGGAGGTTT
TTTTGGGGTTTT
TTTTTPGTTTTT
TTTTTTTTTTTT
11,12